1111111111
1000000001
1011111101
1010000001
1010111101
1000000101
1011100101
1000000101
1010111101
1010000001