1110001111
1000000001
1010000101
1011110101
1010000101
1010111101
1010000101
1010110101
1011111101
1111111111