1111111111
1001111001
1101111011
1100000011
1110000111
1111001111
1100000011
1110000111
1111001111
1111111111