1001110011
1001110001
1010000101
0010000100
0010110100
0000000100
1010110101
1010000101
1010000101
1001110001